AMD3DNowEx	Amd3DNowEx
ARM	Arm
AST	Ast
ASTLowerPhase	AstLowerPhase
ActiveDefs	ActiveDefinitions
ActiveRegionNodeIConstIterator	ActiveRegionNodeIConstantIterator
AddAssemblyUnitRef	AddAssemblyUnitReference
AddCallSiteRef	AddCallSiteReference
AddDefTypeParameters	AddDefinitionTypeParameters
AddElem	AddElement
AddFuncUnitObjects	AddFunctionUnitObjects
AddInScopeSym	AddInScopeSymbol
AddMulReductionOps	AddMultiplyReductionOperations
AddNewInstr	AddNewInstruction
AddOvfWithCarry	AddOverflowWithCarry
AddRTLoc	AddRuntimeLocation
AddReg	AddRegister
AddRegionSeg	AddRegionSegment
AddStaticFieldSym	AddStaticFieldSymbol
AddrAdjust	AddressAdjustment
AddrModeBuilder	AddressModeBuilder
AddrModeBuildingEnabled	AddressModeBuildingEnabled
AddrModeOpndsCtrl	AddressModeOperandsControl
AddrOf	AddressOf
AddrShifter	AddressShifter
AddrTakenTagsBv	AddressTakenTagsBitVector
AdjustForInstr	AdjustForInstruction
AdvanceLiveDescWalker	AdvanceLiveDescriptionWalker
AggrCheckVar	AggregateCheckVariable
AggrStackVarNode	AggregateStackVariableNode
Aggrtype	AggregateType
AggrtypeAggrtypeMap	AggregateTypeAggregateTypeMap
AggrtypeIConstIterator	AggregateTypeIConstantIterator
AliasedIndirs	AliasedIndirections
Align1024Bytes	AlignTo1024Bytes
Align16348Bytes	AlignTo16348Bytes
Align1Byte	AlignTo1Byte
Align2048Bytes	AlignTo2048Bytes
Align2Bytes	AlignTo2Bytes
Align32Bytes	AlignTo32Bytes
Align4Bytes	AlignTo4Bytes
Align64Bytes	AlignTo64Bytes
Align8Bytes	AlignTo8Bytes
AlignBytesToBoundary	AlignmentBytesToBoundary
AlignMask	AlignmentMask
AlignParam	AlignmentParameter
AlignofexprNode	AlignmentOfExpressionNode
AllAutoMemTag	AllAutoMemoryTag
AllLoc	AllLocation
AllNeighborsBV	AllNeighborsBitVector
AllRef	AllReference
AllStaticMemTag	AllStaticMemoryTag
AllocCountCtrl	AllocationCountControl
AllocGCInfo	AllocateGCInfo
AllocId	AllocateId
AllocInstrId	AllocateInstructionId
AllocLifetime	AllocateLifetime
AllocRegForParamType	AllocateRegisterForParameterType
AllocateParamSym	AllocateParameterSymbol
AnalyzeInstr	AnalyzeInstruction
AnnotateInstr	AnnotateInstruction
AppendArgFuncArg	AppendArgumentFunctionArgument
AppendDst	AppendDestination
AppendFuncArg	AppendFunctionArgument
AppendLabelSrc	AppendLabelSource
AppendOpnd	AppendOperand
AppendSrc	AppendSource
AppendUnnamedArg	AppendUnnamedArgument
ArchCanon	ArchitectureCanonicalize
ArchEHLower	ArchitectureEHLower
ArchFrame	ArchitectureFrame
ArchInliner	ArchitectureInliner
ArchIntrin	ArchitectureIntrinsic
ArchLower	ArchitectureLower
ArchSSECtrl	ArchitectureSseControl
AreDepthFirstNumsValid	AreDepthFirstNumbersValid
AreDomsValid	AreDominatorsValid
ArePostDomsValid	ArePostDominatorsValid
Arg	Argument
ArgByteOffset	ArgumentByteOffset
ArgException	ArgumentException
ArgNotConst	ArgumentNotConstant
ArgPtrRegIsUsed	ArgumentPointerRegisterIsUsed
ArgTypeList	ArgumentTypeList
ArrUpper	ArrayUpper
ArraynewNode	ArrayNewNode
ArticulationShiftLeft	ShiftLeftInArticulationNode
ArticulationShiftStrengthReduction	ShiftStrengthReductionInArticulationNode
AsAggrStackVarNode	AsAggregateStackVariableNode
AsAssemblySym	AsAssemblySymbol
AsBaseRegLoc	AsBaseRegisterLocation
AsBasicStackVarNode	AsBasicStackVariableNode
AsBoolCtrlValue	AsBooleanControlValue
AsCallInstr	AsCallInstruction
AsClearBoolCtrl	AsClearBooleanControl
AsCmpInstrCheckRule	AsCompareInstructionCheckRule
AsCntrCtrlValue	AsCounterControlValue
AsCompModCtrl	AsComponentModifierControl
AsConstCell	AsConstantCell
AsConstPropStats	AsConstantPropagationStatistics
AsDataInstr	AsDataInstruction
AsDeadCodeStats	AsDeadCodeStatistics
AsExpNode	AsExpressionNode
AsFieldSym	AsFieldSymbol
AsFrameLoc	AsFrameLocation
AsFuncDebugInfo	AsFunctionDebugInfo
AsFuncOpnd	AsFunctionOperand
AsFuncType	AsFunctionType
AsGlobalVarSym	AsGlobalVariableSymbol
AsImportModuleSym	AsImportModuleSymbol
AsIntCtrl	AsIntControl
AsIntImmOpndBinding	AsIntImmediateOperandBinding
AsLabelOpnd	AsLabelOperand
AsLocalVarSym	AsLocalVariableSymbol
AsMgdArrayCheckVar	AsManagedArrayCheckVariable
AsModRefOpnd	AsAliasOperand
AsMultiCntrCtrlValue	AsMultipleCounterControlValue
AsNonLocalVarSym	AsNonLocalVariableSymbol
AsOpEqOpndBinding	AsOperandsEqualOperandBinding
AsOutlineInstr	AsOutlineInstruction
AsParamRegLoc	AsParameterRegisterLocation
AsPermissionSym	AsPermissionSymbol
AsPlugInCtrlValue	AsPlugInControlValue
AsPrimCheckVar	AsPrimitiveCheckVariable
AsPrimTypeKindCheckConstraint	AsPrimitiveTypeKindCheckConstraint
AsProxyStaticFieldSym	AsProxyStaticFieldSymbol
AsPtrType	AsPointerType
AsRegOpndBinding	AsRegisterOperandBinding
AsRenameStats	AsRenameStatistics
AsRetInstrCheckRule	AsReturnInstructionCheckRule
AsSectSym	AsSectionSymbol
AsSingleCntrCtrlValue	AsSingleCounterControlValue
AsStaticFieldSym	AsStaticFieldSymbol
AsStringCtrlValue	AsStringControlValue
AsTypeDefSymbol	AsTypeDefinitionSymbol
AsTypeSym	AsTypeSymbol
AsTypedefSym	AsTypeDefSymbol
AsUnreachableCodeStats	AsUnreachableCodeStatistics
AsVarOpnd	AsVariableOperand
AsVptrMap	AsVoidPointerMap
AssemblySymFreeList	AssemblySymbolFreeList
AssemblyUnitRefList	AssemblyUnitReferenceList
AssertLimitCtrl	AssertLimitControl
AssignExprTmp	AssignExpressionTemporary
AssignRegClassPseudo	AssignRegisterCategoryPseudo
AssocExternId	AssociatedExternId
Async	Asynchronous
Attr	Attribute
AttrSymFreeList	AttributeSymbolFreeList
AttrSymList	AttributeSymbolList
AttrType	AttributeType
AuxSymTokenDef	AuxiliarySymbolTokenDef
AuxiliarySymbolTokenDef	AuxiliarySymbolTokenDefinition
BadFixupRvaSpanIConstIterator	BadFixupRvaSpanIConstantIterator
BaseOpnd	BaseOperand
BaseRegClass	BaseRegisterCategory
BaseRelocRva	BaseRelocationRva
BaseSym	BaseSymbol
BaseTypeLinkIConstIterator	BaseTypeLinkIConstantIterator
BaseVarSymLoc	BaseVariableSymbolLocation
BasedPtrSub	BasedPointerSubtract
BasicStackVarNode	BasicStackVariableNode
BeforeFieldInit	BeforeFieldInitialize
BeginCompilandEnum	BeginCompilationUnitEnum
BeginInit	BeginInitialization
BeginOpt	BeginOptimization
BeginRegClass	BeginRegisterCategory
BeginUDT	BeginUserDefinedType
BinaryExprWithAssignNode	BinaryExpressionWithAssignNode
BitCompl	BitComplement
BitTestCompl	BitTestComplement
BlkSort	BlockSort
BlockInstrNum	BlockInstructionNumber
Bool	Boolean
BoolCtrlValue	BooleanControlValue
BoolType	BooleanType
BoxAggrType	BoxedAggregateType
BranchInstrFreeList	BranchInstructionFreeList
BranchTargetOpnd	BranchTargetOperand
BreakExprTmp	BreakExpressionTemporary
BuildDefTable	BuildDefinitionTable
BuildDomFrontiers	BuildDominanceFrontiers
BuildFuncIR	BuildFunctionIR
BuildIUCGNodesPhase	BuildInterUnitCallGraphNodesPhase
BuildLoopInfoWithAttr	BuildLoopInfoWithAttribute
BuildPlugInPhases	BuildPlugInPhases
BuildPostDoms	BuildPostDominators
BuildUseDef	BuildUseDefinition
BuildUseDefForExpression	BuildUseDefinitionForExpression
BuildUseDefForMemoryOperand	BuildUseDefinitionForMemoryOperand
Bv	BitVector
BvCode	BitVectorCode
BvPartialDefs	BvPartialDefinitions
BytesReversedHi	BytesReversedHigh
CBranch	ConditionalBranch
CLR	Clr
CLRNativeEllipsis	ClrNativeEllipsis
CModKind	CustomModifierKind
CacheVer	CacheVersion
CallAliasedMemTag	CallAliasedMemoryTag
CallInstrCheckRule	CallInstructionCheckRule
CallSiteInstr	CallSiteInstruction
CallSiteTokenSym	CallSiteTokenSymbol
CallerFuncUnit	CallerFunctionUnit
CanDynamicLocalAlign	CanDynamicallyAlignLocals
CanEnregAggr	CanEnregisterAggregate
CanEnregParam	CanEnregisterParameter
CanEnregRetValueType	CanEnregisterReturnValueType
CanInvertCondCode	CanInvertConditionCode
CanRenameSrc	CanRenameSource
CanReverseCondCode	CanReverseConditionCode
CancelOpnd	CancelOperand
CandidateIConstIterator	CandidateIConstantIterator
CanonAddrModeOpnds	CanonicalizeAddressModeOperands
CanonEnterExitBlock	CanonicalizeEnterExitBlock
CanonFinalPhase	CanonicalizeFinalPhase
CanonPhase	CanonicalizePhase
CanonicalizeOpnd	CanonicalizeOperand
CaseLabelOpndExtensionObject	CaseLabelOperandExtensionObject
CastArchBaseEncode	CastArchitectureBaseEncode
CastArchEHLower	CastArchitectureEHLower
CastArchInliner	CastArchitectureInliner
CastArchLower	CastArchitectureLower
CastCanon	CastCanonicalize
CastHelperSyms	CastHelperSymbols
ChangeCondCode	ChangeConditionCode
ChangeEdgePred	ChangeEdgePredecessor
ChangeEdgeSuccByPrepend	ChangeEdgeSuccessorByPrepending
ChangeLabelSrc	ChangeLabelSource
ChangeSrcToImmediateOpnd	ChangeSourceToImmediateOperand
ChangeToAddrNoType	ChangeToAddressNoType
ChangeToCondBranch	ChangeToConditionBranch
ChangeToIntImm	ChangeToIntImmediate
ChangeToParam	ChangeToParameter
ChangeToRet	ChangeToReturn
ChangeToSym	ChangeToSymbol
ChangeToUnsignedCmp	ChangeToUnsignedCompare
Char16Type	Character16Type
CharSet	CharacterSet
CheckFunc	CheckFunction
CheckSrcAt	CheckSourceAt
CheckUtil	CheckUtility
CheckVarFreeList	CheckVariableFreeList
ChildNodeAddr	ChildNodeAddress
ChkAssign	CheckAssign
ChkNull	CheckNull
ChkSubscript	CheckSubscript
CilReader	CxxILReader
ClassHandlePtr	ClassHandlePointer
ClearBool	ClearBoolean
ClearDefUse	ClearDefinitionUse
CloneOpnd	CloneOperand
ClrInitFrame	ClrInitializationFrame
ClrTokenRef	ClrTokenReference
CmdOriginalRva	CompareOriginalRva
CmpCtrl	CompareControl
CmpInstr	CompareInstruction
CmpInstrFreeList	CompareInstructionFreeList
CmpOperands	CompareOperands
CmpOriginalRvaForSort	CompareOriginalRvaForSort
Cntr	Counter
CntrCtrlValue	CounterControlValue
CodeBufAddr	CodeBufferAddress
CodeGenBaseInit	CodeGenerationBaseInitialize
CodeStr	CodeString
CoerceDst	ForceDestination
CoerceSrc	ForceSource
CoffInit	CoffInitialize
ColorMaxCtrl	ColorMaxControl
ColorOutStats	ColorOutStatistics
ColoroutConflictTestKind	ColorOutConflictTestKind
CombineArgsRev	CombineArgumentsRev
CommonDomFrontier	CommonDominanceFrontier
CommuteSrcs	CommuteSources
CompCtrl	ComponentControl
CompCtrlVector	ComponentControlVector
CompMod	ComponentModifier
CompModCtrlIConstIterator	ComponentModifierControlIConstantIterator
CompParser	ComponentParser
CompilandSym	CompilationUnitSymbol
ComputeBaseWithPrimaryVtable	ComputeBaseWithPrimaryVTable
ComputeInstrRelByteOffset	ComputeInstructionRelativeByteOffset
ComputeIterPostDomFrontier	ComputeIteratorPostDominanceFrontier
CondCode	ConditionCode
CondCodeEntry	ConditionCodeEntry
CondCodeToString	ConditionCodeToString
CondDefInstr	ConditionDefInstruction
ConfidenceIConstIterator	ConfidenceIConstantIterator
Const	Constant
ConstCellFreeList	ConstantCellFreeList
ConstDivSigned32	ConstantDivideInt32
ConstDivUnsigned32	ConstantDivideUInt32
ConstLattice	ConstantLattice
ConstProp	ConstantPropagation
ConstPropStats	ConstantPropagationStatistics
ConstSymFreeList	ConstantSymbolFreeList
ConstSymList	ConstantSymbolList
Consts	Constants
ContArg	ContinuationArgument
ContainsNoMD	ContainsNoMetadata
ContribUnitEnumerationFlags	ContributionUnitEnumerationFlags
ContributionUnitEnumerationFlags	ContributionUnitEnumerationKind
ConvDName	ConvertDecoratedName
ConvKind	ConvertKind
ConvMinFlowToOldForm	ConvertMinFlowToOldForm
ConvOvf	ConvertWithOverflow
ConvSD	ConvertSD
ConvThroughMem	ConvertThroughMemory
ConvertToMinimumFlow	ConvertToMinFlow
CopyBlk	CpBlk
CopyMemOpnd	CopyMemoryOperand
CopyObj	CpObj
CopyOpndEvent	CopyOperandEvent
CopyOpndEventDependencyList	CopyOperandEventDependencyList
CopyPropOpt	CopyPropagatorOption
CopyToMemOpnd	CopyToMemoryOperand
CopyToVarOpnd	CopyToVariableOperand
CountArgsForInstr	CountArgumentsForInstruction
CountRetsForInstr	CountReturnTypesForInstruction
CppEH	CxxEH
CppEhDisabledCtrl	CxxEHDisabledControl
CppMods	CxxModifiers
CreateAndDefineLocalIntrinSym	CreateAndDefineLocalIntrinsicSymbol
CreateDefTokenSym	CreateDefTokenSymbol
CreateDefTokenSymbol	CreateDefinitionTokenSymbol
CreateFuncletSym	CreateNestedFunctionSymbol
CreateGlobalDefs	CreateGlobalDefinitions
CreateInstrs	CreateInstructions
CreateOMapFromSrc	CreateOMapFromSource
CreateOutArgAreaSym	CreateOutArgumentAreaSymbol
CreateRefTokenSym	CreateReferenceTokenSymbol
CreateSubDataInstr	CreateSubDataInstruction
CreateTypeDefOfInt	CreateTypeDefinitionOfInt
CreateTypeRefForRuntimeBuiltInType	CreateTypeReferenceForRuntimeBuiltInType
CrossLinkedLoopTypeDefOfInt	CrossLinkedLoopTypeDefinitionOfInt
CtrlIConstIterator	ControlIConstantIterator
CtrlValue	ControlValue
CtrlVector	ControlVector
CultureStr	CultureString
CurrBitOffset	CurrentBitOffset
CurrDebugTag	CurrentDebugTag
CurrFuncUnit	CurrentFunctionUnit
CurrLineNum	CurrentLineNumber
CurrRegionNode	CurrentRegionNode
CurrentIntRegIndex	CurrentIntRegisterIndex
CurrentMmxRegIndex	CurrentMmxRegisterIndex
CurrentobjectNode	CurrentObjectNode
CustomModifierOfTypeDefOfInt	CustomModifierOfTypeDefinitionOfInt
CxxQueryExceptSize	CxxQueryExceptionSize
CxxUnregisterExceptObject	CxxUnregisterExceptionObject
DLLExpCom	DllExportCommunal
DLLExpDef	DllExportDefinition
DLLExportCom	DllExportCommunal
DLLImport	DllImport
DataFilePtr	DataFilePointer
DataInstr	DataInstruction
DataLoc	DataLocation
DataUnitBaseReloc	DataUnitBaseRelocation
DbgData	DebugData
DeAnnotateInstr	RemoveAnnotationsInstruction
DeadCodeOpt	DeadCodeOptimization
DeadStoresDebugCtrl	DeadStoresDebugControl
DebugCtrl	DebugControl
DebugInfoIConstIterator	DebugInfoIConstantIterator
DecorateFunc	DecorateFunction
Def	Definition
DefInstr	DefInstruction
DefInstruction	DefinitionInstruction
DefMDToken	DefinitionMDToken
DefNum	DefNumber
DefNumToString	DefinitionNumToString
DefNumberToString	DefinitionNumberToString
DefOperandList	DefinitionOperandList
DefOperands	DefinitionOperands
DefOpnd	DefinitionOpnd
DefOpndList	DefinitionOpndList
DefOpndTable	DefinitionOpndTable
DefTypeIndex	DefinitionTypeIndex
DefUseLoc	DefinitionUseLoc
DefUseLocation	DefinitionUseLocation
DefaultCtrl	DefaultControl
DefaultValueSym	DefaultValueSymbol
DefinedTraverser	DefinedWalker
DelayDescriptorSym	DelayDescriptorSymbol
DeleteAllDefsAndUses	DeleteAllDefinitionsAndUses
DeleteDefAndUses	DeleteDefinitionAndUses
DeleteExprInfo	DeleteExpressionInfo
DeleteInstrEventDependencyList	DeleteInstructionEventDependencyList
DeleteInstrEventHandler	DeleteInstructionEventHandler
DeleteNextDef	DeleteNextDefinition
DeleteOpndEventDependencyList	DeleteOperandEventDependencyList
DeleteOpndEventHandler	DeleteOperandEventHandler
DeleteUseDefLink	DeleteUseDefinitionLink
DepBackward	DependencyBackward
DerefBaseOpnd	DereferenceBaseOperand
DeriveMagicNum	DeriveMagicNumber
DescStr	DescriptionString
DescribeInstr	DescribeInstruction
DetachIndexOpnd	DetachIndexOperand
DetectRegVars	DetectRegisterVariables
DetermineAddDstTypeOnCancel	DetermineAddDestinationTypeOnCancel
DiffEngine	DifferenceEngine
DimEqual	DimensionEqual
DisableGSForSym	DisableGuardStackForSymbol
DisasmBlock	DisassembleBlock
DisassembleAndResolveInstr	DisassembleAndResolveInstruction
DispByteOffset	DisplacementByteOffset
DivByShift	DivideByShift
DivOvf	DivideOverflow
DoDynamicAlign	DoDynamicAlignment
DoEvaluateFuncOpnds	DoEvaluateFunctionOperands
DoEvaluatePhiInstrs	DoEvaluatePhiInstructions
DoForwardSubRenaming	DoForwardSubstitutionRenaming
DoIgnoreSignedOvf	DoIgnoreSignedOverflow
DoInsertPsiPhis	DoInsertPsiPhiNodes
DoMakeNewExprTmps	DoMakeNewExpressionTemporaries
DoOmitFramePtr	DoOmitFramePointer
DoPropagateImmOpnd	DoPropagateImmediateOperand
DoReplaceAggrs	DoReplaceAggregates
DoReplaceLabelOpnd	DoReplaceLabelOperand
DoReplacePhiWithConst	DoReplacePhiWithConstant
DoSr	DoStrengthReduction
DoTrackExprTmps	DoTrackExpressionTemporaries
DoUseAggressivePtrMathRules	DoUseAggressivePointerMathRules
Dom	Dominance
DomFrontierSet	DominanceFrontierSet
DontAlloc	DoNotAllocate
DontCheckNonPrimaryInheritance	DoNotCheckNonPrimaryInheritance
DontProcess	DoNotProcess
DotCtrl	DotControl
DotstarNode	DotStarNode
DoubleToLongOvf	DoubleToLongWithOverflow
DoubleToULongOvf	DoubleToULongWithOverflow
DropDepthFirstNums	DropDepthFirstNumbers
DropDoms	DropDominators
DropPostDoms	DropPostDominators
Dst	Destination
DstMayPartialOverlap	DestinationMayPartiallyOverlap
DstMustExactOverlap	DestinationMustExactlyOverlap
DstMustTotalOverlap	DestinationMustTotallyOverlap
DstOpnd	DestinationOperand
DstOpnd2	DestinationOperand2
DstOpndListIndex	DestinationOperandListIndex
DtoractionNode	DestructorActionNode
DummyInstr	DummyInstruction
DumpAllFuncletFrameInfo	DumpAllNestedFunctionFrameInfo
DumpCtrl	DumpControl
DumpDotSuccEdges	DumpDotSuccessorEdges
DumpFG	DumpFlowGraph
DumpFuncMentions	DumpFunctionMentions
DumpFuncUnitWithOffsets	DumpFunctionUnitWithOffsets
DumpIRDebugCtrl	DumpIRDebugControl
DumpInstrReaders	DumpInstructionReaders
DumpIr	DumpIR
DumpLoc	DumpLocation
DumpOriginalRvaCtrl	DumpOriginalRvaControl
DumpRefs	DumpReferences
DumpRegs	DumpRegisters
DumpSyms	DumpSymbols
DumpTypeHashStats	DumpTypeHashStatistics
DumpW	DumpWindow
EHDataInstr	EHDataInstruction
EHLabelSymCtrl	EHLabelSymbolControl
EHOpts	EHOptimizations
EHRegionNodeIConstIterator	EHRegionNodeIConstantIterator
EHandlerSym	ExceptionHandlerSymbol
EdgeModes	EdgeMode
EflagsSym	EflagsSymbol
EhstateslistNode	EHStateListNode
ElemBitSize	ElementBitSize
ElemPrimType	ElementPrimitiveType
ElemType	ElementType
EmbedConstLookup	EmbedConstantLookup
EmitGlobalVarSym	EmitGlobalVariableSymbol
EmitReferencedSyms	EmitReferencedSymbols
EmitStackSym	EmitStackSymbol
EmitTypeDef	EmitTypeDefinition
Emul	ExtendedMultiply
EnclosingFuncletNode	EnclosingNestedFunctionNode
EnclosingFuncletRegion	EnclosingNestedFunctionRegion
EncodeInstrExtensionObject	EncodeInstructionExtensionObject
EncodedIRIConstIterator	EncodedIRIConstantIterator
EncodedRegionSeg	EncodedRegionSegment
EndCompilandEnum	EndCompilationUnitEnum
EndInit	EndInitialization
EndInitEventDelegate	EndInitializationEventDelegate
EndInstr	EndInstruction
EndParseParams	EndParseParameters
EndSectContribEnum	EndSectionContributionEnum
EnlistRootOpnd	EnlistRootOperand
EnterInstr	EnterInstruction
EntryPointSym	EntryPointSymbol
EspOpnd	ESPOperand
EstimateRegClassForType	EstimateRegisterCategoryForType
EvalBlock	EvaluateBlock
EvaluateInstrSetTreeType	EvaluateInstructionSetTreeType
EventSymFreeList	EventSymbolFreeList
ExactDefBackward	ExactDefinitionBackward
ExceptHandlerSym	ExceptionHandlerSymbol
ExceptSectSym	ExceptionSectionSymbol
ExitFunc	ExitFunction
ExitOpndList	ExitOperandList
ExitsFunc	ExitsFunction
ExpDef	ExpDefinition
ExpNode	ExpressionNode
ExpOffset	ExpressionOffset
ExpandAsCondLadder	ExpandAsConditionLadder
ExpandMemCpy	ExpandMemoryCopy
ExpandMemSet	ExpandMemorySet
ExploitableParams	ExploitableParameters
ExportSym	ExportSymbol
ExportSymList	ExportSymbolList
Expr	Expression
ExprBuilder	ExpressionBuilder
ExprCtrl	ExpressionControl
ExprNode	ExpressionNode
ExprTable	ExpressionTable
ExprTmpBv	ExpressionTemporaryBitVector
ExternIdToSym	ExternIdToSymbol
ExternMemTag	ExternalMemoryTag
ExtractSrc	ExtractSource
FPUStatus	FpuStatus
FailFastFuncSym	FailFastFunctionSymbol
FalseLabelInstr	FalseLabelInstruction
FeBuild	C1Build
FeMinor	C1Minor
FieldAddr	FieldAddress
FieldSym	FieldSymbol
FieldSymIConstIterator	FieldSymbolIConstantIterator
FileSym	FileSymbol
Filename	FileName
FilterLabelInstr	FilterLabelInstruction
FinalizeFuncletFrame	FinalizeNestedFunctionFrame
FinalizeMemOpnds	FinalizeMemoryOperands
FinalizeMemOpndsInInstr	FinalizeMemoryOperandsInInstruction
FinalizeSym	FinalizeSymbol
FindCandidateOpnd	FindCandidateOperand
FindExactDefBackwardBlock	FindExactDefinitionBackwardBlock
FindLabelRefKind	FindLabelReferenceKind
FindLabelSrcKind	FindLabelSourceKind
FindNextInstr	FindNextInstruction
FindNextRealInstr	FindNextRealInstruction
FindPos	FindPosition
FindPrevNonPragmaInstr	FindPreviousNonPragmaInstruction
FindRootMemOpnd	FindRootMemoryOperand
FindUnaliasedDomDef	FindUnaliasedDomDefinition
FinishTypeDefs	FinishTypeDefinitions
FirstAlternativeEntryLabelOpnd	FirstAlternativeEntryLabelOperand
FirstAssociatedLabelOpnd	FirstAssociatedLabelOperand
FirstChildReg	FirstChildRegister
FirstDstLabelOpnd	FirstDestinationLabelOperand
FirstDstModRefOpnd	FirstDestinationAliasOperand
FirstExitInstr	FirstExitInstruction
FirstImportModuleSym	FirstImportModuleSymbol
FirstInstr	FirstInstruction
FirstRegionSeg	FirstRegionSegment
FirstSrcLabelOpnd	FirstSourceLabelOperand
FixupDefOperand	FixupDefinitionOperand
Fld	Field
FloatCtrlFlags	FloatControlFlags
FloatDivByZero	FloatDivideByZero
FloatOvf	FloatOverflow
FlowOptsPhase	Phase
FoldMemLeafOpnds	FoldMemoryLeafOperands
ForceIntSrc3	ForceIntSource3
ForceOpndsToMem	ForceOperandToMemory
ForwardSubDefTagSet	ForwardSubDefinitionTagSet
ForwardSubOpndLimit	ForwardSubstitutionOperandLimit
ForwardSubUseTagSet	ForwardSubstitutionUseTagSet
FpDenormal	FPDenormalized
FpNaN	FPNaN
FrameLoc	FrameLocation
FrameSetupOptCtrl	FrameSetupOptimizationControl
FrontEndVer	FrontEndVersion
FuncArg	FunctionArgument
FuncArgFreeList	FunctionArgumentFreeList
FuncArgKind	FunctionArgumentKind
FuncCheckVar	FunctionCheckVariable
FuncDebugEntry	FunctionDebugEntry
FuncDebugEntryList	FunctionDebugEntryList
FuncInfoExtensionObject	FunctionInfoExtensionObject
FuncLinkage	FunctionLinkage
FuncNodeFreeList	FunctionNodeFreeList
FuncOpndFreeList	FunctionOperandFreeList
FuncSymAddOn	FunctionSymbolAddOn
FuncSymFreeList	FunctionSymbolFreeList
FuncSymIConstIterator	FunctionSymbolIConstantIterator
FuncSymRemoveOn	FunctionSymbolRemoveOn
FuncSymWeakSymExtensionObject	FunctionSymbolWeakSymbolExtensionObject
FuncType	FunctionType
FuncUnit	FunctionUnit
FuncUnitList	FunctionUnitList
FuncdeclNode	FunctionDeclarationNode
FuncletFrameInfoIConstIterator	NestedFunctionFrameInfoIConstantIterator
FuncletParamPtrReg	NestedFunctionParameterPointerRegister
FuncletRegion	NestedFunctionRegion
FuncletSymList	NestedFunctionSymbolList
Functype	FunctionType
FunctypeFunctypeMap	FunctionTypeFunctionTypeMap
FunctypeIConstIterator	FunctionTypeIConstantIterator
GCTrackTraverser	GCTrackWalker
GPRelative	GlobalPointerRelative
GSCookieAllocPhase	GuardStackCookieAllocatePhase
GSCookieProtectStartByteOffset	GuardStackCookieProtectStartByteOffset
GSDumpFrameCtrl	GuardStackDumpFrameControl
GSStrictPhase	GuardStackStrictPhase
GenAnd	GenerateAnd
GenBV	GenerateBitVector
GenCaseValueCmp	GenerateCaseValueCompare
GenInit	GenerateInitialize
GenInterfaceTableAccess	GenerateInterfaceTableAccess
GenParamSpill	GenerateParameterSpill
GenPop	GeneratePop
GenPushWithLabel	GeneratePushWithLabel
GenShadowSPSlotsAndAssignments	GenerateShadowStackPointerSlotsAndAssignments
GenTypeVar	GenerateTypeVariable
GenericsCtxtFromInstParam	GenericsContextFromInstanceParameter
GetAlignPaddingSize	GetAlignmentPaddingSize
GetAssemblyDir	GetAssemblyDirectory
GetCallSiteTokenSym	GetCallSiteTokenSymbol
GetColumnNum	GetColumnNumber
GetCondCodeEntry	GetConditionCodeEntry
GetCongruentDefOpnd	GetCongruentDefOperand
GetCurrentNoAlloc	GetCurrentNoAllocate
GetDataPtr	GetDataPointer
GetDefOperand	GetDefinitionOperand
GetDstByIndex	GetDestinationByIndex
GetExactInstrBitSize	GetExactInstructionBitSize
GetExprInfo	GetExpressionInfo
GetFilePtr	GetFilePointer
GetFirstCalleeOrderToRegIdIndex	GetFirstCalleeOrderToRegisterIdIndex
GetFirstExprOpnd	GetFirstExpressionOperand
GetFirstLiveDesc	GetFirstLiveDescription
GetFuncType	GetFunctionType
GetFuncletFrameInfoForRegion	GetNestedFunctionFrameInfoForRegion
GetIndexOfDst	GetIndexOfDestination
GetIndexOfSrc	GetIndexOfSource
GetLabelDefOperand	GetLabelDefinitionOperand
GetLabelDefOpnd	GetLabelDefinitionOpnd
GetLastArgOpnd	GetLastArgumentOperand
GetLegalOpndList	GetLegalOperandList
GetLocId	GetLocationId
GetMDImplFlags	GetMetadataImplementationFlags
GetMgdPtrType	GetManagedPointerType
GetNextDefByBlock	GetNextDefinitionByBlock
GetNextExprOpnd	GetNextExpressionOperand
GetNthArgFuncArg	GetNthArgumentFunctionArgument
GetNthRetType	GetNthReturnType
GetNumEntries	GetNumberEntries
GetOpnd	GetOperand
GetOrderToRegIdArrayForRegClass	GetOrderToRegisterIdArrayForRegisterCategory
GetParentSPRelativeByteOffset	GetParentStackPointerRelativeByteOffset
GetPrimType	GetPrimitiveType
GetPtrFromRva	GetPointerFromRva
GetReachingDef	GetReachingDefinition
GetRegAlloc	GetRegisterAllocator
GetRegClassForType	GetRegisterCategoryForType
GetRegForOpnd	GetRegisterForOperand
GetRegionInsideLabelInstr	GetRegionInsideLabelInstruction
GetRetReg	GetReturnRegister
GetSPRelativeByteOffset	GetStackPointerRelativeByteOffset
GetSsaTagByOpnd	GetSsaTagByOperand
GetSym	GetSymbol
GetTargetArch	GetTargetArchitecture
GetTypeIndexForDef	GetTypeIndexForDefinition
GetUnmgdPtrType	GetUnmanagedPointerType
GetVTablePtr	GetVTablePointer
GetVirtualRegIndex	GetVirtualRegisterIndex
GlobalCallUnwindDelDtor	GlobalCallUnwindDeleteDestructor
GlobalCallUnwindVecDtor	GlobalCallUnwindVectorDestructor
GlobalCtrl	GlobalControl
GlobalDef	GlobalDefinition
GlobalMemConstraintsDebugCtrl	GlobalMemoryConstraintsDebugControl
GlobalPtrRva	GlobalPointerRva
GlobalRegAllocPhase	GlobalRegisterAllocatorPhase
GlobalSyms	GlobalSymbols
GlobalVarSym	GlobalVariableSymbol
GlobalVarSymBiasExtensionObject	GlobalVariableSymbolBiasExtensionObject
Gopt	GlobalOptimizer
GoptJitPhase	GlobalOptimizerJitPhase
GotoLabelInstr	GotoLabelInstruction
GuardStackCookieInitInstr	GuardStackCookieInitializationInstruction
HandlerLabelInstr	HandlerLabelInstruction
HasAddrModeIndex	HasAddressModeIndex
HasAddrModeLea	HasAddressModeLea
HasAllAddrTaken	HasAllAddressTaken
HasAsmEBXMod	HasAsmEBXModifier
HasCompilandDetail	HasCompilationUnitDetail
HasCppEH	HasCxxEH
HasCppObj	HasCxxObject
HasCustomAttr	HasCustomAttribute
HasDefInLoop	HasDefinitionInLoop
HasDefaultCtor	HasDefaultConstructor
HasEhOperationFlow	HasEHOperationFlow
HasFramePtrRelLocals	HasFramePointerRelativeLocals
HasGCPtr	HasGCPointer
HasHFACallConv	HasHomogeneousFloatingPointAggregateCallConvention
HasHandlerRef	HasHandlerReference
HasIntDivByZero	HasIntDivideByZero
HasLabelSrc	HasLabelSource
HasMD	HasMetadata
HasMgdCode	HasManagedCode
HasOnlyOneRef	HasOnlyOneReference
HasPlabels	HasPlabel
HasReg	HasRegister
HasRegOpndBinding	HasRegisterOperandBinding
HasSrc	HasSource
HasVoidRet	HasVoidReturn
HashIndirVars	HashIndirectVariables
HashInstr	HashInstruction
HashLirEncodeCtrl	HashLirEncodeControl
HashTableSize	HashtableSize
HashedHirMappingInstrIConstIterator	HashedHirMappingInstructionIConstantIterator
HashedHirMappingInstrToHashedHirMappingInstrMap	HashedHirMappingInstructionToHashedHirMappingInstructionMap
HashedLirEncodeInstr	HashedLirEncodeInstruction
HashedLirEncodeInstrToHashedLirEncodeInstr	HashedLirEncodeInstructionToHashedLirEncodeInstruction
HashedLirEncodeOpnd	HashedLirEncodeOperand
HeaderInstr	HeaderInstruction
HiZero	HighZero
HoistDstToIndir	HoistDestinationToIndirect
HoistOpndToIndir	HoistOperandToIndirect
HoistPhiSrc	HoistPhiSource
HoistSrc	HoistSource
HoistSrcManual	HoistSourceManual
HoistSrcToMem	HoistSourceToMemory
HoistSrcToRegInRange	HoistSourceToRegisterInRange
IATSym	ImportAddressTableSymbol
IRegionBuilder	RegionBuilder
IVMRunTimeInfo	IVMRuntimeInfo
IdIConstIterator	IdIConstantIterator
IdToInstrMap	IdToInstructionMap
IdToObjMap	IdToObjectMap
IdToOpndMap	IdToOperandMap
IdToRegClassMap	IdToRegisterCategoryMap
IdToSymMap	IdToSymbolMap
IdToVarOpndMap	IdToVariableOperandMap
IgnoreCondCodes	IgnoreConditionCodes
IgnorePtr	IgnorePointer
Imm	Immediate
ImmDomNodes	ImmediateDominanceNodes
ImmOpndFreeList	ImmediateOperandFreeList
ImmPostDomNodes	ImmediatePostDominanceNodes
ImportModuleSym	ImportModuleSymbol
ImportModuleSymList	ImportModuleSymbolList
ImportSym	ImportSymbol
ImportSymCount	ImportSymbolCount
ImportSymList	ImportSymbolList
InBV	InBitVector
IndexOpnd	IndexOperand
IndirAliasedMemTag	IndirectAliasedMemoryTag
IndirSrc	IndirectSource
InductionVarRecognizer	InductionVariableRecognizer
InductionVarRecognizerForShift	InductionVariableRecognizerForShift
InfoFileFuncIConstIterator	InfoFileFunctionIConstantIterator
InfoLineColumnIConstIterator	InfoLineColumnIConstantIterator
InitAlignedBlk	InitializeAlignedBlock
InitAlignedBlk32	InitializeAlignedBlock32
InitCallRegSets	InitializeCallRegisterSets
InitData	InitializeData
InitFunc	InitializeFunction
InitGCFields	InitializeGCFields
InitInfo	InitializeInfo
InitKillRegs	InitializeKillRegisters
InitLocalsFlag	InitializeLocalsFlag
InitOneOpnd	InitializeOneOperand
InitStackAllocate	InitializeStackAllocate
InitTargetTypes	InitializeTargetTypes
InitialAppDomainCtrl	InitialAppDomainControl
InitialLabelInstrMap	InitialLabelInstructionMap
Inlinability	Inlineability
InlineeFuncUnit	InlineeFunctionUnit
InsertAfterDst	InsertAfterDestination
InsertAfterInstrEventDependencyList	InsertAfterInstructionEventDependencyList
InsertAfterOpnd	InsertAfterOperand
InsertAlignCode	InsertAlignmentCode
InsertBeforeDst	InsertBeforeDestination
InsertBeforeInstrEventDependencyList	InsertBeforeInstructionEventDependencyList
InsertBeforeSrc	InsertBeforeSource
InsertInstrEventDelegate	InsertInstructionEventDelegate
InsertLoc	InsertLocation
InsertMemOpndAfter	InsertMemoryOperandAfter
InsertNewDefNum	InsertNewDefNumber
InsertNewDefNumber	InsertNewDefinitionNumber
InsertNewInductionVariableDef	InsertNewInductionVariableDefinition
InsertRangeAfterInstrEvent	InsertRangeAfterInstructionEvent
InsertRangeAfterInstrEventWrapper	InsertRangeAfterInstructionEventWrapper
InsertRangeBeforeInstrEventDependencyList	InsertRangeBeforeInstructionEventDependencyList
InsertRefMap	InsertReferenceMap
InsertUseDefLink	InsertUseDefinitionLink
InstanceMemTag	InstanceMemoryTag
InstantiateLabelSym	InstantiateLabelSymbol
InstantiatedAggrTypeList	InstantiatedAggregateTypeList
Instr	Instruction
InstrBitSize	InstructionBitSize
InstrCodeBytes	InstructionCodeBytes
InstrCost	InstructionCost
InstrEventDelegate	InstructionEventDelegate
InstrHasSideEffect	InstructionHasSideEffect
InstrId	InstructionId
InstrIterKind	InstructionIteratorKind
InstrKind	InstructionKind
InstrRangeEventDelegate	InstructionRangeEventDelegate
InstrToBasicBlockMap	InstructionToBasicBlockMap
InstrToEHRegionNodeMap	InstructionToEHRegionNodeMap
InstrToInstrIConstIterator	InstructionToInstructionIConstantIterator
InstrToInstrMap	InstructionToInstructionMap
InstrToStringDelegate	InstructionToStringDelegate
InstructionIsRegisterPartialDef	InstructionIsRegisterPartialDefinition
IntCtrlValue	IntControlValue
IntDivTag	IntDivideTag
IntImmBitSize	IntImmediateBitSize
IntOvf	IntOverflow
IntShorteningConv	IntShorteningConvert
IntToCtrlMap	IntToControlMap
InterlockedCmpExchangeRuleList	InterlockedCompareExchangeRuleList
InterveningDefInSameBlock	InterveningDefinitionInSameBlock
IntrEnable	InterruptEnable
IntrinEntry	IntrinsicEntry
IntrinMap	IntrinsicMap
IntrinNumToOpcodeTable	IntrinsicNumberToOpcodeTable
InvertCondCode	InvertConditionCode
Ip	IP
Ir	IR
IsAFieldOfHFA	IsAFieldOfHomogeneousFloatingPointAggregate
IsAddrDirectlyTaken	IsAddressDirectlyTaken
IsAddrOf	IsAddressOf
IsAddrTaken	IsAddressTaken
IsAggrCheckVar	IsAggregateCheckVariable
IsAggrType	IsAggregateType
IsAllocatedParamBoolean	IsAllocatedParameterBoolean
IsArchConditionCode	IsArchitectureConditionCode
IsAssemblySym	IsAssemblySymbol
IsAsyncInTry	IsAsynchronousInTry
IsAtEof	IsAtEndOfFile
IsBaseRegLoc	IsBaseRegisterLocation
IsBasicStackVarNode	IsBasicStackVariableNode
IsBool	IsBoolean
IsBoolCtrlValue	IsBooleanControlValue
IsCLRCall	IsClrCall
IsCLRNativeVarArgs	IsClrNativeVariableArguments
IsCallInstrCheckRule	IsCallInstructionCheckRule
IsCdtorParam	IsCopyConstructorParameter
IsClearBoolCtrl	IsClearBooleanControl
IsClrTokenRef	IsClrTokenReference
IsCmpInstr	IsCompareInstruction
IsCntrCtrl	IsCounterControl
IsCodeTargetOpnd	IsCodeTargetOperand
IsComdatSym	IsComdatSymbol
IsCompatibleCtrl	IsCompatibleControl
IsCond	IsConditional
IsConstCell	IsConstantCell
IsConstPropStats	IsConstantPropagationStatistics
IsConstZero	IsConstantZero
IsCopyCtor	IsCopyConstructor
IsCxxInit	IsCxxInitialize
IsDLL	IsDll
IsDLLExportCom	IsDllExportCommunal
IsDanglingDef	IsDanglingDefinition
IsDataInstr	IsDataInstruction
IsDeadCodeStats	IsDeadCodeStatistics
IsDef	IsDefinition
IsDefaultRef	IsDefaultReference
IsDotNetModule	IsClrModule
IsDtor	IsDestructor
IsEquivalentSkipRefLink	IsEquivalentSkipReferenceLink
IsExcept	IsException
IsExitInstr	IsExitInstruction
IsExportSym	IsExportSymbol
IsExprTmp	IsExpressionTemporary
IsFieldDef	IsFieldDefinition
IsFileSym	IsFileSymbol
IsFrameLoc	IsFrameLocation
IsFrameVarSym	IsFrameVariableSymbol
IsFunc	IsFunction
IsFuncDebugInfo	IsFunctionDebugInfo
IsFuncOpnd	IsFunctionOperand
IsFuncType	IsFunctionType
IsFunclet	IsNestedFunction
IsGCAggr	IsGCAggregate
IsGCUnCheckedBarrier	IsGCUncheckedBarrier
IsGSCand	IsGuardStackCandidate
IsGlobalCom	IsGlobalCommunal
IsGlobalRef	IsGlobalReference
IsGotoRef	IsGotoReference
IsHandlerRef	IsHandlerReference
IsHideBySig	IsHideBySignature
IsImmOpnd	IsImmediateOperand
IsImportModuleSym	IsImportModuleSymbol
IsIndir	IsIndirect
IsInductionVar	IsInductionVariable
IsInit	IsInitialize
IsInitOnly	IsInitializeOnly
IsInstantiationParam	IsInstantiationParameter
IsIntCtrlValue	IsIntControlValue
IsIntImmOpndBinding	IsIntImmediateOperandBinding
IsInterlockedIntrin	IsInterlockedIntrinsic
IsLabelOpnd	IsLabelOperand
IsLargeInstr	IsLargeInstruction
IsLocTag	IsLocationTag
IsLocalVarSym	IsLocalVariableSymbol
IsLoopInvariantMemAddr	IsLoopInvariantMemoryAddress
IsMdtFieldDef	IsMdtFieldDefinition
IsMemConstraintModRef	IsMemoryConstraintAlias
IsMemOpnd	IsMemoryOperand
IsMemRef	IsMemoryReference
IsMgdArrayCheckVar	IsManagedArrayCheckVariable
IsMgdAssembly	IsManagedAssembly
IsMgdPtr	IsManagedPointer
IsModRefOpnd	IsAliasOperand
IsModUnaligned	IsModifierUnaligned
IsMsilTypeSym	IsMsilTypeSymbol
IsMultiMap	IsMultipleMap
IsNonLocalVarSym	IsNonLocalVariableSymbol
IsNotCachable	IsNotCacheable
IsNullPtr	IsNullPointer
IsObjPtr	IsObjectPointer
IsOpEqOpndBinding	IsOperandsEqualOperandBinding
IsOrCheckVar	IsOrCheckVariable
IsParam	IsParameter
IsParamRegLoc	IsParameterRegisterLocation
IsPchFile	IsPrecompiledHeaderFile
IsPhysReg	IsPhysicalRegister
IsPlugInCtrl	IsPlugInControl
IsPostFrameGen	IsPostFrameGenerated
IsPow2	IsPowerOf2
IsPrimCheckVar	IsPrimitiveCheckVariable
IsPrimTypeKindCheckConstraint	IsPrimitiveTypeKindCheckConstraint
IsPropertySym	IsPropertySymbol
IsPseudoRegId	IsPseudoRegisterId
IsPtrCheckVar	IsPointerCheckVariable
IsPureFunc	IsPureFunction
IsRVal	IsRValue
IsRefLinked	IsReferenceLinked
IsRefTo	IsReferenceTo
IsReg	IsRegister
IsRegId	IsRegisterId
IsRegOpndBinding	IsRegisterOperandBinding
IsRegSetOpndBinding	IsRegisterSetOperandBinding
IsRegionAlternativeEntryRef	IsRegionAlternativeEntryReference
IsRelAddr	IsRelativeAddress
IsResourceSym	IsResourceSymbol
IsRetInstrCheckRule	IsReturnInstructionCheckRule
IsRuntimeRef	IsRuntimeReference
IsSectSym	IsSectionSymbol
IsSetBoolCtrl	IsSetBooleanControl
IsSingleCntrCtrlValue	IsSingleCounterControlValue
IsSrcDstLivenessOverlap	IsSourceDestinationLivenessOverlap
IsSsaPhiInstr	IsSsaPhiInstruction
IsStdCall	IsStdcall
IsStringCtrl	IsStringControl
IsSubSet	IsSubset
IsSymImm	IsSymbolicImmediate
IsTagRefSameSize	IsTagReferenceSameSize
IsTechRef	IsTechnicalReference
IsThisPtr	IsThisPointer
IsTmpReg	IsTemporaryRegister
IsTypeDefSymbol	IsTypeDefinitionSymbol
IsTypeParam	IsTypeParameter
IsTypeValidFunc	IsTypeValidFunction
IsTypedefSym	IsTypeDefSymbol
IsUncond	IsUnconditional
IsUnk	IsUnknown
IsUnmgdByRef	IsUnmanagedByReference
IsUnmgdPtr	IsUnmanagedPointer
IsUnreachableCodeStats	IsUnreachableCodeStatistics
IsVarAddr	IsVariableAddress
IsVarMem	IsVariableMemory
IsVarSym	IsVariableSymbol
IsWeakRef	IsWeakReference
IterArg	IteratorArgument
IterBackwardEditing	IteratorBackwardEditing
IterBackwardEditingInstr	IteratorBackwardEditingInstruction
IterBackwardEditingRangeInstr	IteratorBackwardEditingRangeInstruction
IterBackwardRange	IteratorBackwardRange
IterBackwardRangeInstr	IteratorBackwardRangeInstruction
IterChild	IteratorChild
IterDataflowDst	IteratorDataflowDestination
IterDataflowSrc	IteratorDataflowSource
IterDef	IterDefinition
IterDst	IteratorDestination
IterEditing	IteratorEditing
IterEditingCaseRef	IteratorEditingCaseReference
IterEditingDataflow	IteratorEditingDataflow
IterEditingDataflowDstAndSrc	IteratorEditingDataflowDestinationAndSource
IterEditingDataflowSrcAndDst	IteratorEditingDataflowSourceAndDestination
IterEditingDstAndSrc	IteratorEditingDestinationAndSource
IterEditingExplicitDst	IteratorEditingExplicitDestination
IterEditingExplicitSrc	IteratorEditingExplicitSource
IterEditingRange	IteratorEditingRange
IterEditingSrcAndDst	IteratorEditingSourceAndDestination
IterExplicitDst	IteratorExplicitDestination
IterExplicitSrc	IteratorExplicitSource
IterForwardBothDataflowOpnd	IteratorForwardBothDataflowOperand
IterForwardBothOpnd	IteratorForwardBothOperand
IterForwardDataflowOpnd	IteratorForwardDataflowOperand
IterForwardDefOpnd	IteratorForwardDefOperand
IterForwardEditingBothExplicitOpnd	IteratorForwardEditingBothExplicitOperand
IterForwardEditingCaseRefLabelOpnd	IteratorForwardEditingCaseReferenceLabelOperand
IterForwardEditingExplicitOpnd	IteratorForwardEditingExplicitOperand
IterForwardEditingLabelOpnd	IteratorForwardEditingLabelOperand
IterForwardEditingOpnd	IteratorForwardEditingOperand
IterForwardEditingRangeInstr	IteratorForwardEditingRangeInstruction
IterForwardEditingUnit	IteratorForwardEditingUnit
IterForwardExportSym	IteratorForwardExportSymbol
IterForwardImportSym	IteratorForwardImportSymbol
IterForwardLabelOpnd	IteratorForwardLabelOperand
IterForwardMember	IteratorForwardMember
IterForwardRangeBasicBlock	IteratorForwardRangeBasicBlock
IterForwardRangeUnit	IteratorForwardRangeUnit
IterForwardUnit	IteratorForwardUnit
IterRange	IteratorRange
IterSrc	IteratorSource
IterUse	IteratorUse
IterativeTopDownReverseCanon	IterativeTopDownReverseCanonicalize
IteratorForwardDefOperand	IteratorForwardDefinitionOperand
KeySpec	KeySpecification
KillBV	KillBitVector
KillRegsTag	KillRegistersTag
LabelInstr	LabelInstruction
LabelKindsCtrl	LabelKindsControl
LabelOpndFreeList	LabelOperandFreeList
LabelOpndList	LabelOperandList
LabelSym	LabelSymbol
LabelSymFreeList	LabelSymbolFreeList
LastCaseLabelOpnd	LastCaseLabelOperand
LastDefUseLocation	LastDefinitionUseLocation
LastExplicitDstOpnd	LastExplicitDestinationOperand
LastInstr	LastInstruction
LastPosReservedTag	LastPositionReservedTag
LastRegionSeg	LastRegionSegment
LatticeIConstIterator	LatticeIConstantIterator
LdElemaRef	LdElemaReference
LeftMostLeafNode	LeftmostLeafNode
LegalOpndFlags	LegalOperandFlags
LegalOpndList	LegalOperandList
LegalizeOpnd	LegalizeOperand
LexicalParentSym	LexicalParentSymbol
LifetimeKindAttr	LifetimeKindAttribute
LineCharBufSize	LineCharacterBufferSize
LineNumFilePtr	LineNumberFilePointer
LineNumsStripped	LineNumbersStripped
LinkedLoopTypeDefOfInt	LinkedLoopTypeDefinitionOfInt
LiveOutBv	LiveOutBitVector
LoadConfigRva	LoadConfigurationRva
LoadGlobalSyms	LoadGlobalSymbols
LoaderSym	LoaderSymbol
LocKind	LocationKind
LocMustTotalOverlap	LocationMustTotallyOverlap
LocalAlign	LocalAlignment
LocalPtrRegIsUsed	LocalPointerRegisterIsUsed
LocalSymReader	LocalSymbolReader
LocalSymsStripped	LocalSymbolsStripped
LocalVarFinder	LocalVariableFinder
LocalVarList	LocalVariableList
LocalVarStackDirection	LocalVariableStackDirection
LocalVarSymFreeList	LocalVariableSymbolFreeList
LocalizeSym	LocalizeSymbol
LongDiv	LongDivide
LongMod	LongModifier
LongMulOvf	LongMultiplyWithOverflow
LongUMod	LongUModifier
LookupCtrl	LookupControl
LookupLabelInstrAtRva	LookupLabelInstructionAtRva
LookupSym	LookupSymbol
LoopAttr	LoopAttribute
LoopIConstIterator	LoopIConstantIterator
LoptAttr	LoopOptimizerAttribute
LowLevelIRBeforeLayoutFuncUnitState	LowLevelIRBeforeLayoutFunctionUnitState
LowerExitFunclet	LowerExitNestedFunction
LowerFinallyDebugCtrl	LowerFinallyDebugControl
MD	Metadata
MDUtils	MetadataUtilities
MIRLowerPhase	MirLowerPhase
MKMaskDuplicate	MatchKindMaskDuplicate
MKMaskIRLevel	MatchKindMaskIRLevel
MKMaskTransform	MatchKindMaskTransform
MSIL	Msil
MSILFloatValue	MsilFloatValue
MainEntryInstr	MainEntryInstruction
MainRegionLabelInstr	MainRegionLabelInstruction
MajorImageVer	MajorImageVersion
MajorOperatingSystemVer	MajorOperatingSystemVersion
MajorVer	MajorVersion
MakeOpndsLegal	MakeOperandsLegal
MakeUnmgdEntry	MakeUnmanagedEntry
MapActualsToFormals	MapActualParametersToFormalParameters
MapInstr	MapInstruction
MarkAddrTakenIfEscaped	MarkAddressTakenIfEscaped
MarkAsEhSafe	MarkAsEHSafe
MarkFuncletRva	MarkNestedFunctionRva
MarkTagAsUnDef	MarkTagAsUnDefinition
MarshalAttrSym	MarshalAttributeSymbol
MatchExceptJump	MatchExceptionJump
MatchInstrForm	MatchInstructionForm
MatchMatchPtr	MatchMatchPointer
MatchRegAlloc	MatchRegisterAllocator
MaxAlign	MaxAlignment
MaxCallTargetDispBitSize	MaxCallTargetDisplacementBitSize
MaxDefNum	MaxDefinitionNum
MaxDstOpndLists	MaxDestinationOperandLists
MaxIterNumPerBlock	MaxIteratorNumberPerBlock
MaxOpnd	MaxOperand
MaxPrePostNum	MaxPrePostNumber
MaxPrologInitsCtrl	MaxPrologInitializationsControl
MaxStateNum	MaxStateNumber
MayHaveUnknownSrc	MayHaveUnknownSource
MayPartialOverlapLoc	MayPartiallyOverlapLocation
MdEmitter	MetadataEmitter
MdSig	MetadataSignature
Mem	Memory
MemCmp	MemoryCompare
MemCpy	MemoryCopy
MemDiscardable	MemoryDiscardable
MemIntrinByteSize	MemoryIntrinsicByteSize
MemIntrinSrc1AlignBytes	MemoryIntrinsicSource1AlignmentBytes
MemLivenessTraverser	MemoryLivenessWalker
MemNotCached	MemoryNotCached
MemOpnd	MemoryOperand
MemOpndAddrModeExtensionObjectFreeList	MemoryOperandAddressModeExtensionObjectFreeList
MemRead	MemoryRead
MemSet	MemorySet
MemShared	MemoryShared
MemStats	MemoryStatistics
MemWrite	MemoryWrite
Mem__Non__Non_	Memory__Non__Non_
Mem__ST0p_Non_	Memory__ST0p_Non_
MemberIConstIterator	MemberIConstantIterator
MemoryStats	MemoryStatistics
MessageStr	MessageString
MetaDataReader	MetadataReader
MgdArray	ManagedArray
MgdArrayCheckVarFreeList	ManagedArrayCheckVariableFreeList
MgdArrayType	ManagedArrayType
MgdPtrCheckVar	ManagedPointerCheckVariable
MgdReferentTypeSig	ManagedReferentTypeSignature
MinAlign	MinAlignment
MinOpnd	MinOperand
MingleSrcCtrl	MingleSourceControl
MinorImageVer	MinorImageVersion
MinorOperatingSystemVer	MinorOperatingSystemVersion
MinorVer	MinorVersion
Mod	Modifier
ModKind	ModifierKind
ModRefOpnd	AliasOperand
ModType	ModifierType
ModuleInit	ModuleInitialize
MonEnter	MonitorEnter
MonExit	MonitorExit
MostRestrictAlign	MostRestrictAlignment
MoveToFrontOfPredList	MoveToFrontOfPredecessorList
MsilTypeSymFreeList	MsilTypeSymbolFreeList
MulOvf	MultiplyWithOverflow
MulStrengthReduction	MultiplyStrengthReduction
Mulshift	ShiftExpansion
MulshiftPhase	ShiftExpansionPhase
MulshiftReduce	ShiftExpansionReduce
MultiByteAlloc	MultipleByteAllocate
MultiCntr	MultipleCounter
MultiMapInsert	MultipleMapInsert
MultiValIterator	MultipleValueIterator
MustExactOverlap	MustExactlyOverlap
MustTotalOverlap	MustTotallyOverlap
MustTrackThisPtr	MustTrackThisPointer
NameIConstIterator	NameIConstantIterator
NameSym	NameSymbol
NameToSymMap	NameToSymbolMap
NamedAttrArg	NamedAttributeArgument
NamedAttrArgList	NamedAttributeArgumentList
NamespaceSymFreeList	NamespaceSymbolFreeList
NaturalAlign	NaturalAlignment
NeedAssignRegClassPseudoRegs	NeedAssignRegisterCategoryPseudoRegisters
NeedRestoreFromPSPSym	NeedRestoreFromParentStackPointerSymbol
NeedsFunclets	NeedsNestedFunctions
NeedsTypeArgCacheInit	NeedsTypeArgumentCacheInitialized
Neg	Negate
NewAlignedLocTag	NewAlignedLocationTag
NewArrayObj	NewArrayObject
NewBinaryNoDst	NewBinaryNoDestination
NewCmpTmp	NewCompareTemporary
NewDisasm	NewDisassembler
NewExpr	NewExpression
NewImm	NewImmediate
NewInstrEventDependencyList	NewInstructionEventDependencyList
NewInstrEventHandler	NewInstructionEventHandler
NewLocTag	NewLocationTag
NewMem	NewMemory
NewMemOpndForVarOpnd	NewMemoryOperandForVariableOperand
NewOpndEvent	NewOperandEvent
NewOpndEventDependencyObject	NewOperandEventDependencyObject
NewOpndEventWrapper	NewOperandEventWrapper
NewRefTag	NewReferenceTag
NewRegAlloc	NewRegisterAllocator
NewSymSize	NewSymbolSize
NewTernaryNoDst	NewTernaryNoDestination
NewTmpAddr	NewTemporaryAddress
NewTmpSym	NewTemporarySymbol
NewUnaryNoDst	NewUnaryNoDestination
NewVarObj	NewVariableObject
NextAlternativeEntryRefLabelOpnd	NextAlternativeEntryReferenceLabelOperand
NextAssociatedRegionRefLabelOpnd	NextAssociatedRegionReferenceLabelOperand
NextDefOperand	NextDefinitionOperand
NextDesc	NextDescription
NextFuncInfoExtensionObject	NextFunctionInfoExtensionObject
NextImportSym	NextImportSymbol
NextInstr	NextInstruction
NextNodeAddr	NextNodeAddress
NextPredEdge	NextPredecessorEdge
NextRegionSeg	NextRegionSegment
NextSuccEdge	NextSuccessorEdge
NextTypeFieldSym	NextTypeFieldSymbol
NextTypePropertySym	NextTypePropertySymbol
NoCheckAssertCtrl	NoCheckAssertControl
NoCommuteCmps	NoCommuteCompares
NoFoldingOvf	NoFoldingOverflow
NoMem	NoMemory
NoRegOrderArray	NoRegisterOrderArray
NoReverseCopyProp	NoReverseCopyPropagation
NodeAST	NodeAst
NodeExceptBody	NodeExceptionBody
NodeExpr	NodeExpression
NodeInit	NodeInitialize
Noduplicates	NoDuplicates
NonLocalVar	NonLocalVariable
NonLocalVarSymFreeList	NonLocalVariableSymbolFreeList
Non__Mem__Non_	Non__Memory__Non_
Non__ST0p_Mem_	Non__ST0p_Memory_
NotAPrimType	NotAPrimitiveType
NotSupportedCppEhFailure	NotSupportedCxxEHFailure
NthPredNode	NthPredecessorNode
NthSuccNode	NthSuccessorNode
NullPtrType	NullPointerType
Num	Number
NumBitsInNode	NumberBitsInNode
NumDefUse	NumDefinitionUse
NumExprOpnds	NumberExpressionOperands
NumLayouts	NumberLayouts
NumMap	NumberMap
NumOpcodes	NumberOpcodes
NumPasses	NumberPasses
NumRegs	NumberRegisters
NumTryRegionsExcludingFunclets	NumberTryRegionsExcludingNestedFunctions
NumUserParamsShadowed	NumberUserParametersShadowed
NumberDefUse	NumberDefinitionUse
ObjFixupDelegate	ObjectFixupDelegate
ObjIConstIterator	ObjectIConstantIterator
ObjPtr	ObjectPointer
ObjPtrSystemStringType	ObjectPointerSystemStringType
ObjToId	ObjectToId
ObjToObj	ObjectToObject
ObjToObjFixupDelegateMap	ObjectToObjectFixupDelegateMap
ObjVector	ObjectVector
ObsoleteCurrToken	ObsoleteCurrentToken
OffCtrl	OffControl
OffsetForExplicitChkNull	OffsetForExplicitCheckNull
OffsetOfArrayFirstRT	OffsetOfArrayFirstReferenceType
OffsetOfArrayLenRT	OffsetOfArrayLengthReferenceType
OffsetOfStrFirst	OffsetOfStringFirst
OffsetsCtrl	OffsetsControl
OpEq	OperandsEqual
OpcodeAttr	OpcodeAttribute
OpcodeDumpInstrToStringEventDependencyList	OpcodeDumpInstructionToStringEventDependencyList
OpcodeX87Args	OpcodeX87Arguments
Opnd	Operand
Opnd2	Operand2
OpndBindingKind	OperandBindingKind
OpndEventDelegate	OperandEventDelegate
OpndKind	OperandKind
OpndListConstants	OperandListConstants
OpndListSelector	OperandListSelector
OpndToBoolean	OperandToBoolean
OpndToSbv	OperandToSparseBitVector
OpndToStringDelegate	OperandToStringDelegate
OpndVector	OperandVector
OptCtrl	OptimizationControl
OptMessage	OptimizationMessage
OrCheckVar	OrCheckVariable
OrderToRegIdForRegClassId	OrderToRegisterIdForRegisterCategoryId
OriginalInstrByteOffset	OriginalInstructionByteOffset
OutBV	OutBitVector
OutlineInstr	OutlineInstruction
OverlapLoc	OverlapLocation
Ovf	Overflow
OvfTest	OverflowTest
OwnerFuncSym	OwnerFunctionSymbol
PEFixupIConstIterator	PEFixupIConstantIterator
PEModuleUnitIConstIterator	PEModuleUnitIConstantIterator
PInvokeCalliFuncSym	PInvokeCalliFunctionSymbol
PValue	PointerToValue
Packedtype	PackedType
PackedtypePackedtype	PackedTypePackedType
PackedtypePackedtypePool	PackedTypePackedTypePool
PackerSubcaseFilterCtrl	PackerSubcaseFilterControl
Param	Parameter
ParamByteOffset	ParameterByteOffset
ParamId	ParameterId
ParamNodeFreeList	ParameterNodeFreeList
ParamPtrRegIsUsed	ParameterPointerRegisterIsUsed
ParamRegLoc	ParameterRegisterLocation
Params	Parameters
ParenNode	ParenthesisNode
ParentAggrType	ParentAggregateType
ParentFuncletNode	ParentNestedFunctionNode
ParentReg	ParentRegister
ParseArgList	ParseArgumentList
ParseArgs	ParseArguments
ParseMethodDefOrReferenceSignature	ParseMethodDefinitionOrReferenceSignature
ParserDumpBoolCtrl	ParserDumpBooleanControl
PartialDefBackward	PartialDefinitionBackward
PartialTagsBv	PartialTagsBitVector
PartialUseOrDefForward	PartialUseOrDefinitionForward
PassRegArgs	PassRegisterArguments
PathFreq	PathFrequency
PchChkSum	PrecompiledHeaderChecksum
PchFileName	PrecompiledHeaderFileName
PchMap	PrecompiledHeaderMap
PchSig	PrecompiledHeaderSignature
PermissionSym	PermissionSymbol
PhaseConfig	PhaseConfiguration
PhxStringIConstIterator	PhxStringIConstantIterator
PlabelSym	PlabelSymbol
PlaceHolderOnly	PlaceholderOnly
PlugInCtrl	PlugInControl
PogoInst	PogoInstance
PopReg	PopRegister
PopulateExportNodesInIUCGPhase	PopulateExportNodesInInterUnitCallGraphPhase
PostDom	PostDominance
PostDomLevel	PostDominanceLevel
PostDumpInstrToStringEventDependencyList	PostDumpInstructionToStringEventDependencyList
PostDumpInstrToStringEventHandler	PostDumpInstructionToStringEventHandler
PostDumpOpndToStringEvent	PostDumpOperandToStringEvent
PostDumpOpndToStringEventWrapper	PostDumpOperandToStringEventWrapper
PostNum	PostNumber
PragmaInstr	PragmaInstruction
PreDumpCtrl	PreDumpControl
PreDumpInstrToStringEventDependencyList	PreDumpInstructionToStringEventDependencyList
PreDumpInstrToStringEventHandler	PreDumpInstructionToStringEventHandler
PreNum	PreNumber
PreProcessStatus	PreprocessStatus
PredCount	PredecessorCount
PredEdgeListTail	PredecessorEdgeListTail
PredefinedCilId	PredefinedCxxILId
PrependInstrToBlock	PrependInstructionToBlock
PrependSrc	PrependSource
PrevFuncInfoExtensionObject	PreviousFunctionInfoExtensionObject
PrevPredEdge	PreviousPredecessorEdge
PrevSiblingNode	PreviousSiblingNode
Prim	Primitive
PrimCheckVarFreeList	PrimitiveCheckVariableFreeList
PrimType	PrimitiveType
PrimTypeKind	PrimitiveTypeKind
PrimTypeKindEntries	PrimitiveTypeKindEntries
PrimTypeKindToString	PrimitiveTypeKindToString
PrimaryBaseAggrType	PrimaryBaseAggregateType
Primtype	PrimitiveType
PrimtypePrimtype	PrimitiveTypePrimitiveType
PrimtypePrimtypePool	PrimitiveTypePrimitiveTypePool
ProcStartSize	ProcessStartSize
ProcessByRefParam	ProcessByReferenceParameter
ProcessCallRetValue	ProcessCallReturnValue
ProcessEnterFunc	ProcessEnterFunction
ProcessInstr	ProcessInstruction
ProcessIntrinHelperArgs	ProcessIntrinsicHelperArguments
ProcessMethodDefOrRefSig	ProcessMethodDefOrReferenceSignature
ProcessMethodDefOrReferenceSignature	ProcessMethodDefinitionOrReferenceSignature
ProcessNonVoidPtrType	ProcessNonVoidPointerType
ProcessOptCustomModifier	ProcessOptionalCustomModifier
ProcessParamCount	ProcessParameterCount
ProcessPreallocatedRegDef	ProcessPreallocatedRegDefinition
ProcessRegParamSym	ProcessRegisterParameterSymbol
ProcessRetType	ProcessReturnType
ProcessTypedByRefParam	ProcessTypedByReferenceParameter
ProcessUnprototypedCallArg	ProcessNotPrototypedCallArgument
ProcessVoidRetType	ProcessVoidReturnType
PromoteAndMergeSymtab	PromoteAndMergeSymbolTable
PropertySym	PropertySymbol
PropertySymFreeList	PropertySymbolFreeList
ProxyStaticFieldSym	ProxyStaticFieldSymbol
PseudoReg	PseudoRegister
PtrCheckVar	PointerCheckVariable
PtrToRawData	PointerToRawData
PtrType	PointerType
Ptrtype	PointerType
PtrtypePtrtype	PointerTypePointerType
PtrtypePtrtypePool	PointerTypePointerTypePool
RTAddr	RuntimeAddress
RTAddrLoc	RuntimeAddressLocation
RTDynamicCastSym	RuntimeDynamicCastSymbol
RaiseToFuncUnitState	RaiseToFunctionUnitState
ReBuildEnterFuncDataflow	RebuildEnterFunctionDataflow
ReSize	Resize
ReadI64	ReadInt64
ReadMetaData	ReadMetadata
ReadOnlyFuncUnit	ReadOnlyFunctionUnit
ReadjustRangeAndResultOpnd	ReadjustRangeAndResultOperand
ReceiveSlottedAggr	ReceiveSlottedAggregate
RecursiveTypeDefInt	RecursiveTypeDefinitionInt
RecursiveTypeDefIntName2	RecursiveTypeDefinitionIntName2
RecursiveTypeDefIntTypeSymbol2	RecursiveTypeDefinitionIntTypeSymbol2
ReduceDivRem	ReduceDivideWithRemainder
Ref	Reference
RefMDToken	ReferenceMetadataToken
RefMemberMap	ReferenceMemberMap
RefToDef	ReferenceToDef
Reg	Register
RegAllocPhase	RegisterAllocatorPhase
RegAttr	RegisterAttribute
RegClass	RegisterCategory
RegCondBitSize	RegisterConditionBitSize
RegConditionType	RegisterConditionType
RegFloatType	RegisterFloatType
RegIdToOrderForRegClassId	RegisterIdToOrderForRegisterCategoryId
RegIntByteSize	RegisterIntByteSize
RegIsCallee	RegisterIsCallee
RegOpndBinding	RegisterOperandBinding
RegSetOpndBinding	RegisterSetOperandBinding
RegUIntType	RegisterUIntType
RegionIConstIterator	RegionIConstantIterator
RegionInstrIterator	RegionInstructionIterator
RegionNodeIConstIterator	RegionNodeIConstantIterator
RegionNodeToInstrMap	RegionNodeToInstructionMap
RegionStackNodeIConstIterator	RegionStackNodeIConstantIterator
RegisterDefaultCtrl	RegisterDefaultControl
RegisterPlugIn	RegisterPlugIn
RegisterizeOpnds	EnregisterOperands
RegsForRegClassIdBV	RegistersForRegisterCategoryIdBitVector
Reinit	Reinitialize
ReloadIntoInstr	ReloadIntoInstruction
Rem	Remainder
RemoveAssemblyUnitRef	RemoveAssemblyUnitReference
RemoveDefunctHandlerLabelOpnd	RemoveDefunctHandlerLabelOperand
RemoveDsts	RemoveDestinations
RemoveExprTmps	RemoveExpressionTemporaries
RemoveInstrToRegionMap	RemoveInstructionToRegionMap
RemoveLabelRef	RemoveLabelReference
RemoveMemOpndChildren	RemoveMemoryOperandChildren
RemoveNoEffectInstrs	RemoveNoEffectInstructions
RemoveNonAlphaNumeric	RemoveNonAlphabeticNumeric
RemovePhiNodeExpr	RemovePhiNodeExpression
RemovePhiSrcsByEdge	RemovePhiSourcesByEdge
RemoveUnreachableCtrl	RemoveUnreachableControl
RenameOpt	RenameOptimization
RenameRegisterDef	RenameRegisterDefinition
RenameUnaliasedDefAndUses	RenameNotAliasedDefAndUses
RenumBaseTag	RenumberBaseTag
ReplaceAndUnlinkDst	ReplaceAndUnlinkDestination
ReplaceAndUnlinkSrc	ReplaceAndUnlinkSource
ReplaceDst	ReplaceDestination
ReplaceLabelSrc	ReplaceLabelSource
ReplaceSrc	ReplaceSource
ReplaceSrcWithIndir	ReplaceSourceWithIndirect
ResetInstrIds	ResetInstructionIds
ResetResultOpnd	ResetResultOperand
ResolveConstValue	ResolveConstantValue
ResolveMinOpnd	ResolveMinOperand
ResolveToDefIrreversibly	ResolveToDefinitionIrreversibly
ResourceSym	ResourceSymbol
RestoreCppEHExceptList	RestoreCxxEHExceptionList
ResultObj	ResultObject
RetAddr	ReturnAddress
RetFinally	ReturnFinally
RetInstr	ReturnInstruction
RetNode	ReturnNode
RetPtr	ReturnPointer
RetypeExprTree	RetypeExpressionTree
RetypeOpnd	RetypeOperand
Reversable	Reversible
ReverseArgs	ReverseArguments
ReverseCondCode	ReverseConditionCode
ReverseGraphPostNum	ReverseGraphPostNumber
ReverseMemParams	ReverseMemoryParameters
RevisionNum	RevisionNumber
Rol	RotateLeft
RootFuncUnit	RootFunctionUnit
Ror	RotateRight
RuntimeIntrin	RuntimeIntrinsic
RvaSpanIConstIterator	RvaSpanIConstantIterator
SEH	Seh
SEHExceptCode	SehExceptionCode
SEHLongJmpSym	SehLongjmpSymbol
SSE2	Sse2
ST0__ST0__Mem_	ST0__ST0__Memory_
STx__Mem__Non_	STx__Memory__Non_
SafeDesc	SafeDescription
SamePreCondition	SamePrecondition
SaveSPinSEHRec	SaveStackPointerInSehRecord
SavedRegsByteOffset	SavedRegistersByteOffset
SbvSbv	SparseBitVectorSparseBitVector
SbvSbvPool	SparseBitVectorSparseBitVectorPool
ScheduleCopyOpndEvent	ScheduleCopyOperandEvent
ScheduleDeleteInstrEvent	ScheduleDeleteInstructionEvent
ScheduleInsertAfterInstrEvent	ScheduleInsertAfterInstructionEvent
ScheduleInsertRangeAfterInstrEvent	ScheduleInsertRangeAfterInstructionEvent
ScheduleNewInstrEvent	ScheduleNewInstructionEvent
ScheduleOpcodeDumpInstrToStringEvent	ScheduleOpcodeDumpInstructionToStringEvent
SchedulePostDumpOpndToStringEvent	SchedulePostDumpOperandToStringEvent
ScheduleUnlinkInstrEvent	ScheduleUnlinkInstructionEvent
ScheduleUnlinkOpndEvent	ScheduleUnlinkOperandEvent
ScopeSymExtensionObject	ScopeSymbolExtensionObject
ScopedExprNode	ScopedExpressionNode
SearchDirs	SearchDirectories
SectContribDetails	SectionContributionDetails
SectSymFreeList	SectionSymbolFreeList
SecurityObjectDesc	SecurityObjectDescription
SeekToLineNum	SeekToLineNumber
SegOpnd	SegmentOperand
SegSS	SegmentSS
SetAllocBase	SetAllocateBase
SetBool	SetBoolean
SetCurrDebugTag	SetCurrentDebugTag
SetEhHandler	SetEHHandler
SetFilePtr	SetFilePointer
SetHandlerLabelOnInstrIfNeeded	SetHandlerLabelOnInstructionIfNeeded
SetJmpEx	SetjmpEx
SetMemConstraints	SetMemoryConstraints
SetMemConstraintsRule	SetMemoryConstraintsRule
SetNthVar	SetNthVariable
SetUnk	SetUnknown
SetVarIndexForNthDst	SetVariableIndexForNthDestination
SetVirtBaseClassPtr	SetVirtualBaseClassPointer
SetupFuncAsRegion	SetupFunctionAsRegion
SetupSEHProlog	SetupSehProlog
SharedStaticFieldAddr	SharedStaticFieldAddress
Shl128	ShiftLeft128
ShortenBranchesDebugCtrl	ShortenBranchesDebugControl
ShouldEnregParam	ShouldEnregisterParameter
Shr	ShiftRight
SiblingDesc	SiblingDescription
Sig	Signature
SigEmitter	SignatureEmitter
SigType	SignatureType
SimpleRvd	SimpleRegisterVariableDetection
SimplifyCmp	SimplifyCompare
SingleCntr	SingleCounter
SingleExplicitDstOpnd	SingleExplicitDestinationOperand
SinkDst	SinkDestination
SinkDstToMem	SinkDestinationToMemory
SinkPhiDst	SinkPhiDestination
SizeFuncAlign	SizeFunctionAlignment
SizelessType	UnsizedType
SizeofSym	SizeofSymbol
SizeofexprNode	SizeOfExpressionNode
SpeedCtrl	SpeedControl
SpillExprTmp	SpillExpressionTemporary
SpillVarArgsRegParams	SpillVariableArgumentsRegisterParameters
Src	Source
SrcAnnotationAttrInfo	SourceAnnotationAttributeInfo
SrcFileName	SrcFileLine
SrcFileNameString	SourceFileNameString
SrcListOffset	SrcListOffset
SrcMayPartiallyOverlap	SourceMayPartialiyOverlap
SrcMustExactlyOverlap	SourceMustExactlyOverlap
SrcMustTotallyOverlap	SourceMustTotallyOverlap
SrcOpnd1	SourceOperand1
SrcOpnd3	SourceOperand3
SrcOpnd5	SourceOperand5
SrcOpndList	SourceOperandList
SrcState	SourceState
SsaAttr	SsaAttribute
SsaPhiInstrFreeList	SsaPhiInstructionFreeList
StackAlloc	StackAllocate
StackCheckCtrl	StackCheckControl
StackOvf	StackOverflow
StackVarNode	StackVariableNode
Stackification	StackOptimization
StartPointFuncSym	StartPointFunctionSymbol
StartupInitMultiMedia	StartupInitializeMultimedia
StaticDef	StaticDefinition
StaticFieldSym	StaticFieldSymbol
StaticFieldSymList	StaticFieldSymbolList
StaticRef	StaticReference
StaticReinitInternal	StaticReinitializeInternal
StatsKind	StatisticsKind
Str	String
StrCmp	StringCompare
StrIConstIterator	StringIConstantIterator
StrSet	StringSet
StrStrMap	StringStringMap
StrengthReductionLhsIConstIterator	StrengthReductionLhsIConstantIterator
StrengthReductionValueIConstIterator	StrengthReductionValueIConstantIterator
StressDialCtrl	StressDialControl
StringCtrl	StringControl
StrongNameSigSym	StrongNameSignatureSymbol
SubFunc	SubFunction
SubOvfWithBorrow	SubtractOverflowWithBorrow
SubWithBorrow	SubtractWithBorrow
SuccCount	SuccessorCount
SuccEdgeListTail	SuccessorEdgeListTail
SummarizeExprTmp	SummarizeExpressionTemporary
SuppressFPO	SuppressFramePointerOmission
SwitchInstrFreeList	SwitchInstructionFreeList
SymAnalyzer	SymbolAnalyzer
SymCount	SymbolCount
SymDebugCtrl	SymbolicDebugControl
SymIConstIterator	SymbolIConstantIterator
SymImmOpnd	SymbolicImmediateOperand
SymKind	SymbolKind
SymNode	SymbolNode
SymOriginationExtensionObj	SymbolOriginationExtensionObject
SymRef	SymbolReference
SymRefMap	SymbolReferenceMap
SymTab	SymbolTable
SymToId	SymbolToId
SymToOpnd	SymbolToOperand
SymToSymRef	SymbolToSymbolReference
SymType	SymbolType
SymbolicDebugCtrl	SymbolicDebugControl
Syms	Symbols
SymsToString	SymbolsToString
SystemObjectAggrType	SystemObjectAggregateType
SystemRuntimeTypeHandleAggrType	SystemRuntimeTypeHandleAggregateType
TableIConstIterator	TableIConstantIterator
TagIConstIterator	TagIConstantIterator
TagIsSym	TagIsSymbol
TagToOpndMap	TagToOperandMap
TagToSym	TagToSymbol
TargetArch	TargetArchitecture
TargetLegalCheckCtrl	TargetLegalCheckControl
TargetSym	TargetSymbol
TearDownFuncletFrame	TearDownNestedFunctionFrame
TernaryExprNode	TernaryExpressionNode
ThisCallRegOrderArray	ThisCallRegisterOrderArray
ThisPtr	ThisPointer
ThisPtrTag	ThisPointerTag
TimeCtrl	TimeControl
Tmp	Temporary
TmpBv	TemporaryBitVector
TmpLivenessTraverser	TemporaryLivenessWalker
TokenDef	TokenDefinition
TokenSymOpnd	TokenSymbolOperand
ToolStampMajorVer	ToolStampMajorVersion
TopDownCanon	TopDownCanonicalize
TotalDefBackward	TotalDefinitionBackward
TotalNonDominatingPhiSrcs	TotalNonDominatingPhiSources
TotalTagsBv	TotalTagsBitVector
TrackedDesc	TrackedDescription
TransferDstList	TransferDestinationList
TransferLabelSrc	TransferLabelSource
TransferModRefOpnds	TransferAliasOperands
TransferSrc	TransferDestinations
TransferSrcs	TransferSources
Traverser	Walker
TrustedUnaliasedMemTag	TrustedNotAliasedMemoryTag
TryObjPtrMgdArrayElemAsObjPtrType	TryObjectPointerManagedArrayElementAsObjectPointerType
TryexceptNode	TryExceptNode
TypeDef	TypeDefinition
TypeDefInt	TypeDefinitionInt
TypeDefName	TypeDefinitionName
TypeDefOfCustomModifierOfInt	TypeDefinitionOfCustomModifierOfInt
TypeDefOfInt	TypeDefinitionOfInt
TypeDefOfTypeRef	TypeDefinitionOfTypeRef
TypeDefSymbol	TypeDefinitionSymbol
TypeDescType	TypeDescriptorType
TypeInit	TypeInitialize
TypeOpndFreeList	TypeOperandFreeList
TypeSymFreeList	TypeSymbolFreeList
TypeSymList	TypeSymbolList
TypeVarType	TypeVariableType
TypeVarTypeList	TypeVariableTypeList
TypedefSym	TypeDefSymbol
TypesCtrl	TypesControl
UIntPtrPrimType	UIntPointerPrimitiveType
UnAliasedType	NotAliasedType
UnModifiedType	UnmodifiedType
UnaliasedMemTag	NotAliasedMemoryTag
UnaliasedScalarsNoEH	NotAliasedScalarsNoEH
Unannotated	NotAnnotated
UnboxAggrType	UnboxAggregateType
UndecorateVar	UndecorateVariable
UndefDefOpnd	UndefDefinitionOpnd
UndefMemTag	UndefinedMemoryTag
UnderlyingPrimType	UnderlyingPrimitiveType
UninitWarningCtrl	UninitializedWarningControl
UninstantiatedEventSym	UninstantiatedEventSymbol
UninstantiatedFuncSym	UninstantiatedFunctionSymbol
UninstantiatedStaticFieldSym	UninstantiatedStaticFieldSymbol
UniqueNonEhPredEdge	UniqueNonEHPredecessorEdge
UniqueNonEhSuccEdge	UniqueNonEHSuccessorEdge
UniqueSuccNode	UniqueSuccessorNode
UnitSym	UnitSymbol
UnkToolsDebugCtrl	UnknownToolsDebugControl
UnlinkAddrModeOpnds	UnlinkAddressModeOperands
UnlinkDst1	UnlinkDestination1
UnlinkInstrEvent	UnlinkInstructionEvent
UnlinkInstrEventDependencyObject	UnlinkInstructionEventDependencyObject
UnlinkInstrEventWrapper	UnlinkInstructionEventWrapper
UnlinkInstrRangeEventDependencyList	UnlinkInstructionRangeEventDependencyList
UnlinkLabelSrc	UnlinkLabelSource
UnlinkOpndEvent	UnlinkOperandEvent
UnlinkOpndEventWrapper	UnlinkOperandEventWrapper
UnlinkSrc1	UnlinkSource1
UnlinkSrc3	UnlinkSource3
UnmapCondCode	UnmapConditionCode
UnmgdArray	UnmanagedArray
UnmgdByRef	UnmanagedByReference
UnmgdPtr	UnmanagedPointer
UnmgdPtrIConstIterator	UnmanagedPointerIConstantIterator
UnmgdPtrVector	UnmanagedPointerVector
UnmgdThunkSym	UnmanagedThunkSymbol
Unprototyped	NotPrototyped
UnsafeMemTag	UnsafeMemoryTag
UnsignedCondCode	UnsignedConditionCode
UntrackedDesc	UntrackedDescription
UnwindInstr	UnwindInstruction
UpdateMDImplFlags	UpdateMetadataImplementationFlags
UpdateSizeForLoc	UpdateSizeForLocation
UseInstr	UseInstruction
UseOpnd1	UseOperand1
UseOpndList	UseOperandList
UsedRegSet	UsedRegisterSet
Util	Utility
VCCRT	Vccrt
VTableFixupsSym	VTableFixupsSymbol
ValueIConstIterator	ValueIConstantIterator
ValueInstrFreeList	ValueInstructionFreeList
VarArgHandleParamSym	VariableArgumentHandleParameterSymbol
VarArgs	VariableArguments
VarOpndFreeList	VariableOperandFreeList
VcgCtrl	VcgControl
VcgEdgeLabelStr	VcgEdgeLabelString
VcgIdStr	VcgIdString
VcgInfo2Str	VcgInfo2String
Ver	Version
VerNum	VersionNumber
VerifyExprTmp	VerifyExpressionTemporary
VisibilityIsDef	VisibilityIsDefinition
VisitAssemblySym	VisitAssemblySymbol
VisitAttrSymListExtensionObject	VisitAttributeSymbolListExtensionObject
VisitBaseVarSymLoc	VisitBaseVariableSymbolLocation
VisitCallInstr	VisitCallInstruction
VisitCmpInstr	VisitCompareInstruction
VisitConstSym	VisitConstantSymbol
VisitDataLoc	VisitDataLocation
VisitEventSym	VisitEventSymbol
VisitFieldSym	VisitFieldSymbol
VisitFrameLoc	VisitFrameLocation
VisitFuncInfoExtensionObject	VisitFunctionInfoExtensionObject
VisitFuncSym	VisitFunctionSymbol
VisitFuncType	VisitFunctionType
VisitGlobalVarSym	VisitGlobalVariableSymbol
VisitGlobalVarSymBiasExtensionObject	VisitGlobalVariableSymbolBiasExtensionObject
VisitImportModuleSym	VisitImportModuleSymbol
VisitInstr	VisitInstruction
VisitLabelInstr	VisitLabelInstruction
VisitLabelSym	VisitLabelSymbol
VisitLoc	VisitLocation
VisitMemOpnd	VisitMemoryOperand
VisitMgdArrayType	VisitManagedArrayType
VisitMsilTypeSym	VisitMsilTypeSymbol
VisitNonLocalVarSym	VisitNonLocalVariableSymbol
VisitOpndExtensionObject	VisitOperandExtensionObject
VisitOutlineInstr	VisitOutlineInstruction
VisitPermissionSym	VisitPermissionSymbol
VisitPrimType	VisitPrimitiveType
VisitPropertySymExtensionObject	VisitPropertySymbolExtensionObject
VisitPtrType	VisitPointerType
VisitRTTIOpndExtensionObject	VisitRuntimeTypeInformationOperandExtensionObject
VisitResourceSym	VisitResourceSymbol
VisitScopeSymExtensionObject	VisitScopeSymbolExtensionObject
VisitSsaPhiInstr	VisitSsaPhiInstruction
VisitSwitchInstr	VisitSwitchInstruction
VisitSymExtensionObject	VisitSymbolExtensionObject
VisitTokenSymExtensionObject	VisitTokenSymbolExtensionObject
VisitTypeOpnd	VisitTypeOperand
VisitTypeVarType	VisitTypeVariableType
VisitUnmgdArrayType	VisitUnmanagedArrayType
VisitVarOpnd	VisitVariableOperand
VisitXDataInstrExtensionObject	VisitXDataInstructionExtensionObject
VolatileStressDialCtrl	VolatileStressDialControl
VptrIConstIterator	VoidPointerIConstantIterator
VptrMap	VoidPointerMap
VptrToObjMap	VoidPointerToObjectMap
VptrToSymMap	VoidPointerToSymbolMap
VptrToTypeMap	VoidPointerToTypeMap
VptrToVptrMap	VoidPointerToVoidPointerMap
WasEmittedInMD	WasEmittedInMetadata
WcsCmp	WideStringCompare
WcsLen	WideStringLength
WeakRef	WeakReference
Win32VerValue	Win32VersionValue
WorkItemIConstIterator	WorkItemIConstantIterator
WriteImm	WriteImmediate
WriteOMapToSrc	WriteOMapToSource
WriteSrcFileRange	WriteSourceFileRange
Writeable	Writable
X86CilReaderHelper	X86CxxILReaderHelper
X87AllocPhase	X87AllocatePhase
X87Attr	X87Attribute
XDataSectSym	XDataSectionSymbol
Xdata	XData
XdataSym	XDataSymbol
_FirstKind	FirstKindSentinel
_HIR_UpperBound	HirUpperSentinel
_Invalid	IllegalSentinel
_LIR_UpperBound	LirUpperSentinel
_Lea	LoadEffectiveAddress
_NumCondCodes	ConditionCodesCountSentinel
_NumPtrTypeKinds	PointerTypeKindsCountSentinel
_UpperBound	UpperSentinel
abssSymbol	AbssSymbol
acosdSymbol	AcosdSymbol
adddSymbol	AdddSymbol
allocaProbeSymbol	AllocaProbeSymbol
arithmeticLongLongMultiplySymbol	ArithmeticLongLongMultiplySymbol
arithmeticLongLongShiftLeftSymbol	ArithmeticLongLongShiftLeftSymbol
arithmeticUnsignedLongLongDivideSymbol	ArithmeticUnsignedLongLongDivideSymbol
arithmeticUnsignedLongLongShiftRightSymbol	ArithmeticUnsignedLongLongShiftRightSymbol
asindSymbol	AsindSymbol
atan2Symbol	Atan2Symbol
atan2fSymbol	Atan2fSymbol
atandSymbol	AtandSymbol
blocksInIdOrder	BlocksInIdOrder
ceildSymbol	CeildSymbol
ceilsSymbol	CeilsSymbol
checkRuleKind	CheckRuleKind
chkstkSymbol	ChkstkSymbol
controlValueKind	ControlValueKind
cosdSymbol	CosdSymbol
coshSymbol	CoshSymbol
coshfSymbol	CoshfSymbol
cxxFrameHandlerSymbol	CxxFrameHandlerSymbol
debugInfoKind	DebugInfoKind
divi64Symbol	Divi64Symbol
divideWithRemainderInt64Symbol	DivideWithRemainderInt64Symbol
divu64Symbol	Divu64Symbol
dtoi64Symbol	Dtoi64Symbol
dtosSymbol	DtosSymbol
edgesToSplit	EdgesToSplit
eqsSymbol	EqsSymbol
expSymbol	ExpSymbol
floorSymbol	FloorSymbol
floorfSymbol	FloorfSymbol
fmodSymbol	FmodSymbol
ftolSymbol	FtolSymbol
gesSymbol	GesSymbol
getExceptionPointersSymbol	GetExceptionPointersSymbol
gtdSymbol	GtdSymbol
guardStackHandlerCheckEHSymbol	GuardStackHandlerCheckEHSymbol
guardStackHandlerCheckSymbol	GuardStackHandlerCheckSymbol
i64tosSymbol	I64tosSymbol
interlockedDecrementSymbol	InterlockedDecrementSymbol
interlockedIncrementSymbol	InterlockedIncrementSymbol
itosSymbol	ItosSymbol
lesSymbol	LesSymbol
libmAcosfSymbol	LibmAcosfSymbol
libmAsinfSymbol	LibmAsinfSymbol
libmAtanSymbol	LibmAtanSymbol
libmCosSymbol	LibmCosSymbol
libmExpSymbol	LibmExpSymbol
libmLog10Symbol	LibmLog10Symbol
libmLogSymbol	LibmLogSymbol
libmPowSymbol	LibmPowSymbol
libmSinSymbol	LibmSinSymbol
libmTanSymbol	LibmTanSymbol
localUnwindHelperSymbol	LocalUnwindHelperSymbol
log10dSymbol	Log10dSymbol
logSymbol	LogSymbol
logfSymbol	LogfSymbol
ltdSymbol	LtdSymbol
map	Map
memoryCompareSymbol	MemoryCompareSymbol
memorySetSymbol	MemorySetSymbol
mulsSymbol	MulsSymbol
nedSymbol	NedSymbol
negsSymbol	NegsSymbol
nodeKind	NodeKind
powSymbol	PowSymbol
powfSymbol	PowfSymbol
processOrderHead	ProcessOrderHead
rotateLeft64Symbol	RotateLeft64Symbol
rotateRight64Symbol	RotateRight64Symbol
runtimeCastToVoidSymbol	RuntimeCastToVoidSymbol
safetyTag	SafetyTag
securityCookieSymbol	SecurityCookieSymbol
setjmpExSymbol	SetjmpExSymbol
signatureBuffer	SignatureBuffer
sinSymbol	SinSymbol
sinfSymbol	SinfSymbol
sinhdSymbol	SinhdSymbol
sqrtSymbol	SqrtSymbol
sqrtfSymbol	SqrtfSymbol
stodSymbol	StodSymbol
stoiSymbol	StoiSymbol
subdSymbol	SubdSymbol
tanSymbol	TanSymbol
tanfSymbol	TanfSymbol
tanhdSymbol	TanhdSymbol
typeKind	TypeKind
utodSymbol	UtodSymbol
